1111111111111111111111111111111111
1E0000000N00000C00000C000000000001
1010N1010010000010100100NNN0010101
101001001010101000100100NNN0010101
1P00N0000C00C00000000000N0000000C1
1111111111111111111111111111111111