1111111111111
10N10000000C1
10000111110N1
1P0N11E0000N1
1111111111111